XXXXXXXXXXXXXXXXXXXXXXXXXXXXXXXXXXXXXXXXXXXXXXXXXXXXXXXXXXXXXXXXXXXXXXXXXXXXXXXX
X000000000000000000000000000000000000000000000000000000000000000000000000000000X
X000000000000000000000000000000000000000000000000000000000000000000000000000000X
X000000000000000000000000000000000000000000000000000000000000000000000000000000X
X000000000000000000000000000000000000000000000000000000000000000000000000000000X
X000000000000000000000000000000000000000000000000000000000000000000000000000000X
X000000000000000000000000000000000000000000000000000000000000000000000000000000X
X000000000000000000000000000000000000000000000000000000000000000000000000000000X
X000000000000000000000000000000000000000000000000000000000000000000000000000000X
X000000000000000000000000000000000000000000000000000000000000000000000000000000X
X000000000000000000000000000000000000000000000000000000000000000000000000000000X
X000000000000000000000000000000000000000000000000000000000000000000000000000000X
X000000000000000000000000000000000000000000000000000000000000000000000000000000X
X000000000000000000000000000000000000000000000000000000000000000000000000000000X
X000000000000000000000000000000000000000000000000000000000000000000000000000000X
X000000000000000000000000000000000000000000000000000000000000000000000000000000X
X000000000000000000000000000000000000000000000000000000000000000000000000000000X
X000000000000000000000000000000000000000000000000000000000000000000000000000000X
X000000000000000000000000000000000000000000000000000000000000000000000000000000X
X000000000000000000000000000000000000000000000000000000000000000000000000000000X
X000000000000000000000000000000000000000000000000000000000000000000000000000000X
X000000000000000000000000000000000000000000000000000000000000000000000000000000X
X000000000000000000000000000000000000000000000000000000000000000000000000000000X
X000000000000000000000000000000000000000000000000000000000000000000000000000000X
X000000000000000000000000000000000000000000000000000000000000000000000000000000X
X000000000000000000000000000000000000000000000000000000000000000000000000000000X
X000000000000000000000000000000000000000000000000000000000000000000000000000000X
X000000000000000000000000000000000000000000000000000000000000000000000000000000X
X000000000000000000000000000000000000000000000000000000000000000000000000000000X
X000000000000000000000000000000000000000000000000000000000000000000000000000000X
X0000000XXXXXXXX000000000000000000000000000000000000000000000000000000000000000X
X0000000XXXXXXXX000000000000000000000000000000000000000000000000000000000000000X
X000000000000000000000000000000000000000000000000000000000000000000000000000000X
X000000000000000000000000000000000000000000000000000000000000000000000000000000X
X0000000000000000XXXXX000000000000000000000000000000000000000000000000000000000X
X0000000000000000XXXXX000000000000000000000000000000000000000000000000000000000X
X000000000000000000000000000000000000000000000000000000000000000000000000000000X
X000000000000000000000000000000000000000000000000000000000000000000000000000000X
XXXXXX0000000000000000000000000000000000000000000000000000000000000000000000000X
XXXXXX0000000000000000000000000000000000000000000000000000000000000000000000000X
X000000000000000000000000000000000000000000000000000000000000000000000000000000X
X000000000000000000000000000000000000000000000000000000000000000000000000000000X
X000000000000000000000000000000000000000000000000000000000000000000000000000000X
X000000000000000000000000000000000000000000000000000000000000000000000000000000X
XXXXXXXXXXXXXXXXXXXXXXXXXXXXXXXXXXXXXXXXXXXXXXXXXXXXXXXXXXXXXXXXXXXXXXXXXXXXXXXX
